[5,5]
(3,3)
(3,2) | (0,1)
(4,0,1,1)
(4,1,1,1)
(0,3,1,1)
(2,0,1,0)
(3,2,1,1)
(1,4,3,2)
(0,4,2,0)
