[5,5]
(4,3)
(4,2) | (0,3)
(0,4,0,2)
(0,4,0,0)
(0,4,1,0)
(0,0,0,0)
(1,3,3,3)
