[5,5]
(3,2)
(0,2) | (4,4)
(3,3,1,1)
(0,2,1,1)
(0,1,3,3)
(4,3,1,0)
(1,2,3,1)
