[5,5]
(1,4)
(2,1) | (4,0)
(4,0,0,2)
(1,1,0,0)
(2,4,0,0)
(0,1,0,1)
(3,2,1,0)
(0,4,0,1)
(0,3,2,4)
