[5,5]
(2,4)
(4,4) | (0,1)
(0,3,0,0)
(3,3,1,0)
(2,1,0,0)
(2,1,1,0)
(4,2,2,3)
(1,2,0,1)
