[5,5]
(0,3)
(0,1) | (1,4)
(2,4,0,0)
(1,2,0,3)
(1,4,1,1)
(0,1,0,0)
(4,0,1,0)
(3,1,0,0)
(4,4,0,0)
(2,1,0,1)
(2,4,3,3)
