[5,5]
(4,4)
(4,4) | (0,2)
(1,1,2,4)
(4,0,1,0)
(2,0,1,1)
(4,2,1,0)
(1,0,1,1)
(2,3,4,2)
