[5,5]
(2,4)
(1,4) | (0,0)
(0,3,4,0)
(0,3,1,1)
(3,3,0,1)
(3,1,0,0)
(0,4,2,2)
(1,1,3,1)
(4,0,1,4)
