[5,5]
(1,4)
(4,0) | (3,2)
(3,3,0,1)
(4,3,2,1)
(1,0,1,2)
(3,2,0,0)
(3,4,1,1)
(3,2,1,0)
(0,4,1,4)
