[5,5]
(2,2)
(0,1) | (2,0)
(0,4,0,4)
(1,3,1,1)
(4,4,0,0)
(3,4,0,0)
(4,0,0,0)
(1,4,4,2)
