[5,5]
(2,4)
(2,1) | (4,4)
(2,4,0,1)
(4,0,0,0)
(2,2,1,0)
(0,2,0,1)
(1,0,0,0)
(1,1,0,0)
(3,2,0,0)
(1,3,3,4)
