[5,5]
(1,3)
(1,3) | (0,2)
(4,1,0,1)
(4,0,0,0)
(4,3,0,1)
(2,4,1,1)
(3,3,4,2)
