[5,5]
(4,2)
(4,4) | (0,0)
(1,1,0,0)
(2,0,1,0)
(2,4,1,1)
(2,0,1,0)
(4,4,1,4)
