[5,5]
(4,1)
(1,0) | (0,3)
(1,2,0,1)
(2,0,4,1)
(4,0,0,4)
(2,1,1,1)
(4,1,1,3)
(4,0,0,3)
