[5,5]
(2,2)
(3,0) | (4,2)
(3,3,1,0)
(2,4,0,0)
(1,2,1,0)
(2,1,1,0)
(3,0,3,3)
(3,3,0,4)
