[5,5]
(1,2)
(0,0) | (2,3)
(4,4,1,0)
(2,0,0,1)
(3,1,4,1)
(0,4,0,1)
(1,1,0,1)
(1,4,1,0)
(2,1,0,0)
(3,1,3,4)
