[5,5]
(2,0)
(4,2) | (0,0)
(2,1,1,1)
(0,1,1,1)
(3,4,1,1)
(0,2,1,1)
(4,3,2,3)
(3,1,4,0)
