[5,5]
(1,0)
(4,1) | (1,2)
(4,2,4,0)
(3,0,1,1)
(3,0,0,0)
(0,0,0,0)
(0,2,1,0)
(4,2,3,2)
(0,4,1,0)
(2,0,3,3)
