[5,5]
(2,2)
(4,0) | (3,4)
(3,2,0,0)
(4,3,1,1)
(3,4,0,0)
(4,3,0,0)
(4,3,1,1)
(3,3,1,0)
(0,3,0,0)
(4,4,1,1)
(1,0,1,0)
(2,1,1,0)
(2,3,4,4)
