[5,5]
(3,2)
(2,3) | (0,4)
(1,4,0,0)
(4,4,0,1)
(2,3,1,1)
(4,2,0,1)
(1,2,1,0)
(4,0,3,2)
(0,4,4,0)
