[5,5]
(4,4)
(1,4) | (2,0)
(2,2,3,2)
(3,0,0,1)
(3,2,0,1)
(2,4,0,1)
(3,3,1,1)
(3,0,0,1)
(3,1,3,4)
