[5,5]
(2,3)
(3,2) | (0,3)
(3,0,0,0)
(3,4,0,1)
(2,3,1,0)
(4,4,4,1)
(2,0,3,1)
