[5,5]
(4,4)
(0,2) | (4,4)
(2,1,1,0)
(2,4,0,0)
(1,0,0,0)
(1,2,0,1)
(0,1,1,0)
(4,0,0,1)
(0,4,2,4)
(4,2,0,1)
