[5,5]
(1,0)
(3,1) | (1,0)
(4,3,0,1)
(0,4,1,0)
(1,1,0,1)
(3,3,0,0)
(4,2,1,0)
(4,4,2,3)
