[5,5]
(2,1)
(4,3) | (1,2)
(4,0,1,1)
(3,4,0,1)
(2,2,0,1)
(0,2,0,0)
(0,3,0,0)
(1,3,0,0)
(0,0,1,1)
(4,3,2,4)
(2,3,1,0)
