[5,5]
(2,0)
(2,0) | (1,4)
(0,0,1,0)
(0,1,1,1)
(1,2,0,1)
(4,2,0,0)
(3,0,0,0)
(4,1,1,0)
(3,4,2,4)
(3,1,1,1)
(3,1,2,3)
