[5,5]
(4,4)
(0,2) | (3,3)
(1,0,2,4)
(1,0,1,0)
(4,3,0,0)
(2,3,1,0)
(2,2,1,0)
(0,3,1,0)
(0,2,4,4)
