[5,5]
(0,2)
(4,4) | (3,0)
(4,1,0,1)
(0,1,0,0)
(0,0,0,0)
(4,0,4,1)
(0,0,0,0)
(2,0,2,2)
