[5,5]
(4,1)
(0,4) | (1,0)
(3,4,4,0)
(1,3,1,0)
(1,3,0,1)
(1,0,1,0)
(2,0,4,2)
(2,3,1,1)
(1,3,0,1)
(4,1,1,0)
(3,0,0,0)
(0,4,1,1)
(4,3,2,3)
